XXXXX
XSX X
X X X
X   X
X   X
XXFXX