XXXXXXX
X X   X
XSX X X
X XXX F
X   X X
XXXXXXX
